	#####S###############
	#                   #
	#    m              #
	#                   #
	#              m    #
	#                   #
	#                   #
	#                   #
	##########e##########
	